###############################################################################
#..........##......................##                  #######  ######  #######
#          ##      ......          ##...       ....... ##   ##  #    #       ##
#                                  #####       ####### #######  #    #      # #
#          ##                      ##                  ##   ##  #    #     #  #
#                                                      #######  ######    #   #
#             #####  ###################                                      #
#                                                                             #
#   # ####### ##               #.......  ##############  ###### ##### ####    #
#      ..     ##   ####################                  ##                   #
#      ..     ##               #.......  ## ......            ......          #
#          ...                    #.......  ##          ... ##                #
###############################################################################